{
  "width": 16,
  "height": 16,
  "tiles": [
    1,1,1,1,1,1,1,1,1,1,1,1,1,1,1,1,
    1,2,2,2,2,2,2,2,2,2,2,2,2,2,2,1,
    1,2,2,2,2,2,2,2,2,2,2,2,2,2,2,1,
    1,2,2,2,2,2,2,2,2,2,2,2,2,2,2,1,
    1,2,2,2,2,2,2,2,2,2,2,2,2,2,2,1,
    1,2,2,2,2,2,2,2,2,2,2,2,2,2,2,1,
    1,2,2,2,2,2,2,2,2,2,2,2,2,2,2,1,
    1,2,2,2,2,2,2,2,2,2,2,2,2,2,2,1,
    1,2,2,2,2,2,2,2,2,2,2,2,2,2,2,1,
    1,2,2,2,2,2,2,2,2,2,2,2,2,2,2,1,
    1,2,2,2,2,2,2,2,2,2,2,2,2,2,2,1,
    1,2,2,2,2,2,2,2,2,2,2,2,2,2,2,1,
    1,2,2,2,2,2,2,2,2,2,2,2,2,2,2,1,
    1,2,2,2,2,2,2,2,2,2,2,2,2,2,2,1,
    1,2,2,2,2,2,2,2,2,2,2,2,2,2,2,1,
    1,1,1,1,1,1,1,1,1,1,1,1,1,1,1,1
  ]
}
